0 0 0 0 0 0 5 0 6 0 0 0 0 0 0 0 0 0 0 0 0 0 0 0 0 6 0 0 0 0
0 1 1 0 1 1 1 0 1 1 1 0 1 1 1 0 1 1 1 1 1 0 1 2 1 0 1 1 0 1
1 1 1 0 1 0 0 0 0 2 0 0 1 1 1 0 1 1 1 1 1 1 1 0 1 1 0 1 0 1
1 0 1 1 1 0 1 0 1 1 0 1 1 1 1 1 0 1 1 1 1 1 1 0 1 1 1 1 0 1
1 0 0 1 0 0 1 0 0 0 0 0 1 1 0 0 1 1 1 0 0 5 0 0 2 0 0 0 0 1
0 0 0 1 0 1 1 0 1 1 6 0 1 1 1 1 1 0 0 3 0 1 1 1 0 1 3 1 0 1
0 0 0 0 0 1 0 0 0 0 1 1 1 1 1 1 1 1 1 4 0 1 1 1 0 1 0 1 0 0
0 1 1 0 1 1 2 2 1 1 0 0 1 1 1 1 0 0 0 0 1 1 0 1 1 1 1 1 0 1
0 0 0 0 0 0 0 0 0 1 1 0 6 0 0 0 0 1 1 1 1 1 1 1 1 0 0 0 5 1
1 1 0 0 0 1 1 1 0 1 1 0 1 2 1 0 0 1 1 1 0 1 1 1 1 1 0 0 1 1
1 1 1 0 1 0 1 1 0 0 0 0 0 2 1 0 1 1 0 1 1 1 1 1 0 1 1 0 1 1
1 0 0 0 1 1 1 1 1 1 1 1 1 2 1 0 0 1 1 1 1 1 1 1 1 6 0 0 1 0
1 1 0 1 0 1 1 0 1 1 1 1 0 0 1 0 6 0 0 2 1 1 0 1 1 1 1 0 1 1
1 1 0 1 1 1 0 1 1 1 1 1 1 1 1 0 1 1 1 2 1 1 1 1 4 4 0 0 0 0
0 1 0 1 6 1 1 0 2 0 2 0 0 0 6 0 2 1 1 2 1 1 0 0 1 1 1 0 1 0
1 1 0 1 0 0 0 0 1 1 1 1 2 1 1 1 0 1 1 0 1 0 1 1 1 1 1 1 2 0
1 0 0 6 2 1 1 0 0 2 1 0 1 0 0 1 0 1 0 0 0 0 0 0 2 2 0 0 0 1
1 1 1 1 1 1 1 1 1 0 0 0 0 1 1 0 0 0 0 0 1 1 1 1 1 1 1 1 1 1
1 1 0 6 0 1 0 1 0 0 1 1 0 1 1 1 1 1 1 1 6 2 2 0 1 0 6 0 0 1
0 0 0 0 6 0 0 0 0 0 1 0 2 7 0 0 0 6 6 6 6 1 0 6 0 0 1 1 0 0